11111111111111111111111111111
11000000000000000000000001011
11000000000000000100000001111
11000000000000001C10000011111
1111000000000000000000010E111
1100000000P000000000000000111
11111111111111111111111111111