1111111
10001C1
100ECP1
1111111
