11111111111111111111111111111
11000000000000000000000000C11
1100C00000000C000000000C00011
1E000000C00000000000C00000111
11000C00000000C0000000C000011
11P000000000C0000000000000E11
111111111111111111111111111E1
