11111111111111111111111111111
11000000000000000000000001011
11000000000000000000000001111
11000000000000000C00000001111
111100000000000000000000E1111
1100000000P000000000000000111
11111111111111111111111111111