11111111111111111111111111111
11000000000000000000000000C11
11000000000000000100000001111
11000000000000001010000011111
1111000000000000000000010P111
11000000000E00000000000000111
11111111111111111111111111111