
11111111111111111111111111111
11000000000000000000000000011
1100000000000000000C000000011
11000000000000000000000000111
11000000000000000000000001111
1100000000P000000000000E00111
11111111111111111111111111111

