1111111111111111111111111111111111
11C000000000000C00000C000000000001
1CEC010100100000101001000000010101
10C0010010101010001001000000010111
100000000C00C100000000000000000C11
100000000000000C00000C000000000001
1010010100100000101001000000010101
1010010010101010001001000000010111
1P0000000C00C100000000000000000C11
100000000000000C00000C000000000001
1010010100100000101001000000010101
1010010010101010001001000000010111
100000000C00C100000000000000000C11
100000000000000C00000C000000000001
1010010100100000101001000000010101
1010010010101010001001000000010111
100000000C00C100000000000000000C11
1111111111111111111111111111111111