1111111111111
100100000C001
11100001111E1
1000011111001
1P00000000001
1111111111111