1111111111111
1001000000001
111000C111011
1000011111P01
100000000E101
1111111111111