1111111111111
100100000C001
11111111111E1
1000011111001
1P00000000001
1111111111111